   _____  ____  _  ______  ____          _   _ 
  / ____|/ __ \| |/ / __ \|  _ \   /\   | \ | |
 | (___ | |  | | ' / |  | | |_) | /  \  |  \| |
  \___ \| |  | |  <| |  | |  _ < / /\ \ | . ` |
  ____) | |__| | . \ |__| | |_) / ____ \| |\  |
 |_____/ \____/|_|\_\____/|____/_/    \_\_| \_|

