#################
#$            O #
#    X          #
#               #
#################
